L_kind    Total    Add    Del    Status
--------  -------  -----  -----  --------
COUNT     0        +0     -0     OK
PROVI     1000     +999   -0     FAIL
AREA      0        +0     -0     OK
LOCAL     0        +0     -0     OK
DISTR     0        +0     -0     OK
BLOCK     0        +0     -0     OK
OTHER     0        +0     -0     OK
