{
    "corpus_parts": [
        3379359569, 
        3371572530, 
        3366402955, 
        3375669612, 
        3356935318, 
        3381162004
    ]
}