{
    "corpus_parts": [
        3371578184, 
        3361155393, 
        3379482434, 
        3375732091, 
        3366594735, 
        3381169669
    ]
}