{
    "corpus_parts": [
        2787208728, 
        2785318338, 
        2772398060, 
        2764218350, 
        2793832614, 
        2797754499
    ]
}