{
    "corpus_parts": [
        3374975792, 
        3356797665, 
        3370806434, 
        3360725629, 
        3378690773, 
        3381421030
    ]
}